WOOOOOOOOOOOOOOOOOOW
|OOBOOOOOOEOOOOOBOO|
|L----OOOOOOOOL----|
|OOOOOOOOM--OOOOOOO|
|OOOOOOOOOOOOOOOOOO|
|OOOOOOOOM--OOOOOOO|
|OOOOOOOBOOOBOOOOOO|
|OOOOL----L----OOOO|
|OOOOOOOOOOOOOOOOOO|
|HOOOOOOOOOOOOOOOOO|
|L----OOOOOOOOL----|
|OOOO7OOOOOOOO7OOOO|
|OOOO7OOOOOOOO7OOOO|
|OOOOS-OOOOOOOS-OOO|
|OOOO7OOOOOOOO7OOOO|
|OOOO7OOOOOOOO7OOOO|
|OOOOS-OOOOOOOS-OOO|
|OOOO7OOOOOOOO7OOOO|
|OOOO7OOIIIIOO7OOOO|
F------------------|