WOOOOOOOOOOOOOOOOOOW
|OOOOOOOOOOOOOOOOOO|
|OOOOOOOOOOOOOOOOOO|
|OOOOOOOOOOOOOOOOOO|
|OOOOOOOM--OOOOOOOO|
|OOOOOOOOOOOOOOOOOO|
|OBOOOOOOOOOOOOOOIO|
S-OOOM--M--S-S-OOOS-
|OOOOOOOOOOOOOOOOOO|
|OOOOOOOOBOOOOOOOOO|
S-OOOM--M--S-S-OOOS-
|OOOOOOOOOOOOOOOOOO|
|OIOOOOOOOOOOOOOOBO|
S-OOOM--M--S-S-OOOS-
|OOOOOOOOOOOOOOOOOO|
|OOOOOOOOEOOOOOOOOO|
S-OOOM--M--S-S-OOOS-
|OOOOOOOOOOOOOOOOOO|
|HOOOOOOOOOOOOOOOOO|
F------------------|