WOOOOOOOOOOOOOOOOOOW
|OOOOOOOOOOOOOOOOOO|
|OOS--OOS--OOS--OOO|
|OOL----OOL----OOOO|
|OOOOOOOOOOOOOOOOOO|
|OOOOOOM--M--OOOOOO|
|OOBOOOOOOOOOOOOBOO|
|OOS--OOS--OOS--OOO|
|OOOOOOOOOOOOOOOOOO|
|OOOOOL----OOOOOOOO|
|OOOOOOOOOOOOOOOEOO|
|OOM--OOOOOOM--OOOO|
|OOOOOOOOIOOOOOOOOO|
|OOS--OOS--OOS--OOO|
|OOOOOOOOOOOOOOOOOO|
|OOOOOM--M--OOOOOOO|
|OOBOOOOOOOOOOOOBOO|
|OOL----OOL----OOOO|
|HOOOOOOOOOOOOOOOOO|
F------------------|