WOOOOOOOOOOOOOOOOOOW
|OOOOOOOOOOOOOOOOOO|
|OOOL----OOOS-S-OOO|
|OOO7OOOOOOOOOO7OOO|
|OOO7OOOOOOOOOB7OO7|
|OOOS-OOOOEOOOS-OOO|
|OOO7OOOOOOOOOO7OOO|
|OOO7OOOS-S-OOO7OO7|
|OOO7OOOOOOOOOO7OOO|
|OOO7HOOOOOOOOO7OOO|
|OOO7L----L----7OO7|
|OOOOOOOOOOOOOOOOOO|
|OOOOOOOOBOOOOOOOOO|
|OOOOOOOOOOOOOOOOO7|
|OOOOOIOOOIOOOIOOOO|
|OOO7L----L----7OOO|
|OOOOOOOOOIOOOOOOOO|
|OOOOOOOL----OOOOOO|
|OOOOOOOOOOOOOOOOOB|
F------------------|